1111111111
1P000010E1
1001001001
1001000001
1111111111
